ID	Phylum	Type
Cyanidioschyzon_merolae	Rhodophyta	No_Flowering
Galdieria_phlegrea	Rhodophyta	No_Flowering
Galdieria_sulphuraria	Rhodophyta	No_Flowering
Porphyridium_purpureum	Rhodophyta	No_Flowering
Porphyra_umbilicalis	Rhodophyta	No_Flowering
Chondrus_crispus	Rhodophyta	No_Flowering
Gracilariopsis_chorda	Rhodophyta	No_Flowering
Prasinoderma_coloniale	Prasinodermophyta	No_Flowering
Chloropicon_primus	Chlorophyta	No_Flowering
Tetrabaena_socialis	Chlorophyta	No_Flowering
Micromonas_pusilla	Chlorophyta	No_Flowering
Micromonas_commoda	Chlorophyta	No_Flowering
Ostreococcus_tauri	Chlorophyta	No_Flowering
Bathycoccus_prasinos	Chlorophyta	No_Flowering
Asterochloris_glomerata	Chlorophyta	No_Flowering
Coccomyxa_subellipsoidea	Chlorophyta	No_Flowering
Ulva_mutabilis	Chlorophyta	No_Flowering
Auxenochlorella_protothecoides	Chlorophyta	No_Flowering
Chlorella_variabilis	Chlorophyta	No_Flowering
Chlorella_sorokiniana	Chlorophyta	No_Flowering
Micractinium_conductrix	Chlorophyta	No_Flowering
Caulerpa_lentillifera	Chlorophyta	No_Flowering
Chromochloris_zofingiensis	Chlorophyta	No_Flowering
Raphidocelis_subcapitata	Chlorophyta	No_Flowering
Monoraphidium_neglectum	Chlorophyta	No_Flowering
Chlamydomonas_schloesseri	Chlorophyta	No_Flowering
Chlamydomonas_eustigma	Chlorophyta	No_Flowering
Chlamydomonas_incerta	Chlorophyta	No_Flowering
Dunaliella_salina	Chlorophyta	No_Flowering
Haematococcus_pluvialis	Chlorophyta	No_Flowering
Chlamydomonas_reinhardtii	Chlorophyta	No_Flowering
Gonium_pectorale	Chlorophyta	No_Flowering
Volvox_reticuliferus	Chlorophyta	No_Flowering
Volvox_africanus	Chlorophyta	No_Flowering
Volvox_carteri	Chlorophyta	No_Flowering
Klebsormidium_flaccidum	Klebsormidiophyceae	No_Flowering
Chara_braunii	Charophyceae	No_Flowering
Mesotaenium_endlicherianum	Zygnematophyceae	No_Flowering
Penium_margaritaceum	Zygnematophyceae	No_Flowering
Marchantia_polymorpha	Marchantiophyta	No_Flowering
Physcomitrella_patens	Bryophyta	No_Flowering
Calohypnum_plumiforme	Bryophyta	No_Flowering
Fontinalis_antipyretica	Bryophyta	No_Flowering
Pleurozium_schreberi	Bryophyta	No_Flowering
Anthoceros_angustus	Anthocerotales	No_Flowering
Anthoceros_agrestis	Anthocerotales	No_Flowering
Anthoceros_punctatus	Anthocerotales	No_Flowering
Selaginella_moellendorffii	Lycopodiophyta	No_Flowering
Abies_alba	Lycopodiophyta	No_Flowering
Gnetum_montanum	Lycopodiophyta	No_Flowering
Sequoiadendron_giganteum	Lycopodiophyta	No_Flowering
Amborella_trichopoda	basal Angiosperms	Flowering
Euryale_ferox	basal Angiosperms	Flowering
Nymphaea_colorata	basal Angiosperms	Flowering
Nymphaea_thermarum	basal Angiosperms	Flowering
Piper_nigrum	Magnoliidae	Flowering
Liriodendron_chinense	Magnoliidae	Flowering
Magnolia_biondii	Magnoliidae	Flowering
Chimonanthus_salicifolius	Magnoliidae	Flowering
Cinnamomum_kanehirae	Magnoliidae	Flowering
Persea_americana	Magnoliidae	Flowering
Zostera_marina	Monocotyledoneae	Flowering
Zostera_muelleri	Monocotyledoneae	Flowering
Wolffia_australiana	Monocotyledoneae	Flowering
Lemna_minor	Monocotyledoneae	Flowering
Spirodela_polyrhiza	Monocotyledoneae	Flowering
Spirodela_intermedia	Monocotyledoneae	Flowering
Trichopus_zeylanicus	Monocotyledoneae	Flowering
Dioscorea_rotundata	Monocotyledoneae	Flowering
Dioscorea_dumetorum	Monocotyledoneae	Flowering
Asparagus_officinalis	Monocotyledoneae	Flowering
Allium_sativum	Monocotyledoneae	Flowering
Apostasia_shenzhenica	Monocotyledoneae	Flowering
Vanilla_planifolia	Monocotyledoneae	Flowering
Dendrobium_catenatum	Monocotyledoneae	Flowering
Phalaenopsis_equestris	Monocotyledoneae	Flowering
Phalaenopsis_aphrodite	Monocotyledoneae	Flowering
Calamus_simplicifolius	Monocotyledoneae	Flowering
Phoenix_dactylifera	Monocotyledoneae	Flowering
Areca_catechu	Monocotyledoneae	Flowering
Elaeis_guineensis	Monocotyledoneae	Flowering
Zingiber_officinale	Monocotyledoneae	Flowering
Ensete_ventricosum	Monocotyledoneae	Flowering
Musa_schizocarpa	Monocotyledoneae	Flowering
Musa_itinerans	Monocotyledoneae	Flowering
Musa_acuminata	Monocotyledoneae	Flowering
Musa_balbisiana	Monocotyledoneae	Flowering
Ananas_comosus	Monocotyledoneae	Flowering
Kobresia_littledalei	Monocotyledoneae	Flowering
Cleistogenes_songorica	Monocotyledoneae	Flowering
Oropetium_thomaeum	Monocotyledoneae	Flowering
Eleusine_coracana	Monocotyledoneae	Flowering
Eleusine_indica	Monocotyledoneae	Flowering
Zoysia_matrella	Monocotyledoneae	Flowering
Zoysia_pacifica	Monocotyledoneae	Flowering
Zoysia_japonica	Monocotyledoneae	Flowering
Eragrostis_tef	Monocotyledoneae	Flowering
Eragrostis_curvula	Monocotyledoneae	Flowering
Eragrostis_nindensis	Monocotyledoneae	Flowering
Zea_mays	Monocotyledoneae	Flowering
Coix_lacryma-jobi	Monocotyledoneae	Flowering
Sorghum_bicolor	Monocotyledoneae	Flowering
Miscanthus_lutarioriparius	Monocotyledoneae	Flowering
Miscanthus_sinensis	Monocotyledoneae	Flowering
Saccharum_spp	Monocotyledoneae	Flowering
Saccharum_spontaneum	Monocotyledoneae	Flowering
Panicum_miliaceum	Monocotyledoneae	Flowering
Dichanthelium_oligosanthes	Monocotyledoneae	Flowering
Digitaria_exilis	Monocotyledoneae	Flowering
Panicum_hallii	Monocotyledoneae	Flowering
Cenchrus_purpureus	Monocotyledoneae	Flowering
Setaria_viridis	Monocotyledoneae	Flowering
Alloteropsis_semialata	Monocotyledoneae	Flowering
Echinochloa_crus-galli	Monocotyledoneae	Flowering
Zizania_palustris	Monocotyledoneae	Flowering
Leersia_perrieri	Monocotyledoneae	Flowering
Oryza_granulata	Monocotyledoneae	Flowering
Oryza_brachyantha	Monocotyledoneae	Flowering
Oryza_coarctata	Monocotyledoneae	Flowering
Oryza_officinalis	Monocotyledoneae	Flowering
Oryza_rhizomatis	Monocotyledoneae	Flowering
Oryza_sativa	Monocotyledoneae	Flowering
Oryza_glaberrima	Monocotyledoneae	Flowering
Bonia_amplexicaulis	Monocotyledoneae	Flowering
Guadua_angustifolia	Monocotyledoneae	Flowering
Olyra_latifolia	Monocotyledoneae	Flowering
Raddia_guianensis	Monocotyledoneae	Flowering
Raddia_distichophylla	Monocotyledoneae	Flowering
Brachypodium_hybridum	Monocotyledoneae	Flowering
Brachypodium_stacei	Monocotyledoneae	Flowering
Brachypodium_distachyon	Monocotyledoneae	Flowering
Puccinellia_tenuiflora	Monocotyledoneae	Flowering
Avena_eriantha	Monocotyledoneae	Flowering
Avena_atlantica	Monocotyledoneae	Flowering
Secale_cereale	Monocotyledoneae	Flowering
Hordeum_vulgare	Monocotyledoneae	Flowering
Aegilops_tauschii	Monocotyledoneae	Flowering
Triticum_urartu	Monocotyledoneae	Flowering
Triticum_aestivum	Monocotyledoneae	Flowering
Triticum_turgidum	Monocotyledoneae	Flowering
Eschscholzia_californica	Early-diverging eudicotyledons	Flowering
Macleaya_cordata	Early-diverging eudicotyledons	Flowering
Papaver_somniferum	Early-diverging eudicotyledons	Flowering
Kingdonia_uniflora	Early-diverging eudicotyledons	Flowering
Coptis_chinensis	Early-diverging eudicotyledons	Flowering
Aquilegia_coerulea	Early-diverging eudicotyledons	Flowering
Thalictrum_thalictroides	Early-diverging eudicotyledons	Flowering
Nelumbo_nucifera	Early-diverging eudicotyledons	Flowering
Macadamia_integrifolia	Early-diverging eudicotyledons	Flowering
Tetracentron_sinense	Early-diverging eudicotyledons	Flowering
Trochodendron_aralioides	Early-diverging eudicotyledons	Flowering
Malania_oleifera	Santalales	Flowering
Fagopyrum_tataricum	Caryophyllales	Flowering
Fagopyrum_esculentum	Caryophyllales	Flowering
Aldrovanda_vesiculosa	Caryophyllales	Flowering
Dionaea_muscipula	Caryophyllales	Flowering
Drosera_spatulata	Caryophyllales	Flowering
Simmondsia_chinensis	Caryophyllales	Flowering
Phytolacca_americana	Caryophyllales	Flowering
Selenicereus_undatus	Caryophyllales	Flowering
Dianthus_caryophyllus	Caryophyllales	Flowering
Amaranthus_palmeri	Caryophyllales	Flowering
Amaranthus_tuberculatus	Caryophyllales	Flowering
Amaranthus_hybridus	Caryophyllales	Flowering
Amaranthus_hypochondriacus	Caryophyllales	Flowering
Suaeda_aralocaspica	Caryophyllales	Flowering
Beta_patula	Caryophyllales	Flowering
Beta_vulgaris	Caryophyllales	Flowering
Spinacia_oleracea	Caryophyllales	Flowering
Atriplex_hortensis	Caryophyllales	Flowering
Chenopodium_pallidicaule	Caryophyllales	Flowering
Chenopodium_quinoa	Caryophyllales	Flowering
Hydrangea_macrophylla	Asterids	Flowering
Davidia_involucrata	Asterids	Flowering
Camptotheca_acuminata	Asterids	Flowering
Nyssa_sinensis	Asterids	Flowering
Nyssa_yunnanensis	Asterids	Flowering
Diospyros_oleifera	Asterids	Flowering
Diospyros_lotus	Asterids	Flowering
Aegiceras_corniculatum	Asterids	Flowering
Primula_vulgaris	Asterids	Flowering
Primula_veris	Asterids	Flowering
Camellia_sinensis	Asterids	Flowering
Roridula_gorgonias	Asterids	Flowering
Actinidia_eriantha	Asterids	Flowering
Clethra_arborea	Asterids	Flowering
Vaccinium_myrtillus	Asterids	Flowering
Vaccinium_corymbosum	Asterids	Flowering
Vaccinium_macrocarpon	Asterids	Flowering
Vaccinium_microcarpum	Asterids	Flowering
Rhododendron_delavayi	Asterids	Flowering
Rhododendron_williamsianum	Asterids	Flowering
Rhododendron_griersonianum	Asterids	Flowering
Rhododendron_simsii	Asterids	Flowering
Lonicera_japonica	Asterids	Flowering
Panax_ginseng	Asterids	Flowering
Daucus_carota	Asterids	Flowering
Apium_graveolens	Asterids	Flowering
Coriandrum_sativum	Asterids	Flowering
Carthamus_tinctorius	Asterids	Flowering
Cynara_cardunculus	Asterids	Flowering
Lactuca_sativa	Asterids	Flowering
Taraxacum_kok-saghyz	Asterids	Flowering
Helianthus_annuus	Asterids	Flowering
Stevia_rebaudiana	Asterids	Flowering
Mikania_micrantha	Asterids	Flowering
Artemisia_annua	Asterids	Flowering
Chrysanthemum_seticuspe	Asterids	Flowering
Chrysanthemum_nankingense	Asterids	Flowering
Fraxinus_excelsior	Asterids	Flowering
Olea_europaea	Asterids	Flowering
Boea_hygrometrica	Asterids	Flowering
Buddleja_alternifolia	Asterids	Flowering
Antirrhinum_majus	Asterids	Flowering
Jacaranda_mimosifolia	Asterids	Flowering
Handroanthus_impetiginosus	Asterids	Flowering
Strobilanthes_cusia	Asterids	Flowering
Genlisea_aurea	Asterids	Flowering
Utricularia_gibba	Asterids	Flowering
Utricularia_reniformis	Asterids	Flowering
Striga_asiatica	Asterids	Flowering
Phtheirospermum_japonicum	Asterids	Flowering
Erythranthe_luteus	Asterids	Flowering
Erythranthe_guttatus	Asterids	Flowering
Callicarpa_americana	Asterids	Flowering
Tectona_grandis	Asterids	Flowering
Pogostemon_cablin	Asterids	Flowering
Scutellaria_barbata	Asterids	Flowering
Scutellaria_baicalensis	Asterids	Flowering
Ocimum_sanctum	Asterids	Flowering
Mentha_longifolia	Asterids	Flowering
Salvia_miltiorrhiza	Asterids	Flowering
Salvia_splendens	Asterids	Flowering
Catharanthus_roseus	Asterids	Flowering
Calotropis_gigantea	Asterids	Flowering
Asclepias_syriaca	Asterids	Flowering
Ophiorrhiza_pumila	Asterids	Flowering
Chiococca_alba	Asterids	Flowering
Mitragyna_speciosa	Asterids	Flowering
Gardenia_jasminoides	Asterids	Flowering
Coffea_arabica	Asterids	Flowering
Coffea_canephora	Asterids	Flowering
Cuscuta_australis	Asterids	Flowering
Cuscuta_campestris	Asterids	Flowering
Ipomoea_triloba	Asterids	Flowering
Ipomoea_nil	Asterids	Flowering
Nicotiana_sylvestris	Asterids	Flowering
Nicotiana_tabacum	Asterids	Flowering
Nicotiana_tomentosiformis	Asterids	Flowering
Datura_stramonium	Asterids	Flowering
Capsicum_baccatum	Asterids	Flowering
Capsicum_annuum	Asterids	Flowering
Capsicum_chinense	Asterids	Flowering
Solanum_commersonii	Asterids	Flowering
Solanum_phureja	Asterids	Flowering
Solanum_aethiopicum	Asterids	Flowering
Solanum_tuberosum	Asterids	Flowering
Solanum_chacoense	Asterids	Flowering
Solanum_chilense	Asterids	Flowering
Solanum_pennellii	Asterids	Flowering
Solanum_lycopersicum	Asterids	Flowering
Solanum_pimpinellifolium	Asterids	Flowering
Paeonia_suffruticosa	Saxifragales	Flowering
Kalanchoe_fedtschenkoi	Saxifragales	Flowering
Rhodiola_crenulata	Saxifragales	Flowering
Vitis_amurensis	Vitales	Flowering
Vitis_vinifera	Vitales	Flowering
Vitis_riparia	Vitales	Flowering
Vitis_rotundifolia	Vitales	Flowering
Punica_granatum	Malvids	Flowering
Corymbia_citriodora	Malvids	Flowering
Eucalyptus_grandis	Malvids	Flowering
Sclerocarya_birrea	Malvids	Flowering
Pistacia_vera	Malvids	Flowering
Xanthoceras_sorbifolium	Malvids	Flowering
Dimocarpus_longan	Malvids	Flowering
Acer_yangbiense	Malvids	Flowering
Acer_truncatum	Malvids	Flowering
Toona_sinensis	Malvids	Flowering
Atalantia_buxifolia	Malvids	Flowering
Citrus_unshiu	Malvids	Flowering
Citrus_ichangensis	Malvids	Flowering
Citrus_clementina	Malvids	Flowering
Poncirus_trifoliata	Malvids	Flowering
Citrus_sinensis	Malvids	Flowering
Citrus_grandis	Malvids	Flowering
Citrus_medica	Malvids	Flowering
Theobroma_cacao	Malvids	Flowering
Bombax_ceiba	Malvids	Flowering
Durio_zibethinus	Malvids	Flowering
Corchorus_capsularis	Malvids	Flowering
Corchorus_olitorius	Malvids	Flowering
Hibiscus_syriacus	Malvids	Flowering
Hibiscus_cannabinus	Malvids	Flowering
Gossypioides_kirkii	Malvids	Flowering
Gossypium_australe	Malvids	Flowering
Gossypium_turneri	Malvids	Flowering
Gossypium_raimondii	Malvids	Flowering
Gossypium_longicalyx	Malvids	Flowering
Gossypium_herbaceum	Malvids	Flowering
Gossypium_arboreum	Malvids	Flowering
Gossypium_barbadense	Malvids	Flowering
Gossypium_tomentosum	Malvids	Flowering
Gossypium_mustelinum	Malvids	Flowering
Gossypium_hirsutum	Malvids	Flowering
Gossypium_darwinii	Malvids	Flowering
Moringa_oleifera	Malvids	Flowering
Carica_papaya	Malvids	Flowering
Tarenaya_hassleriana	Malvids	Flowering
Microthlaspi_erraticum	Malvids	Flowering
Eutrema_salsugineum	Malvids	Flowering
Raphanus_raphanistrum	Malvids	Flowering
Brassica_rapa	Malvids	Flowering
Brassica_juncea	Malvids	Flowering
Megacarpaea_delavayi	Malvids	Flowering
Cardamine_hirsuta	Malvids	Flowering
Arabidopsis_thaliana	Malvids	Flowering
Camelina_sativa	Malvids	Flowering
Capsella_grandiflora	Malvids	Flowering
Capsella_rubella	Malvids	Flowering
Lobularia_maritima	Malvids	Flowering
Megadenia_pygmaea	Malvids	Flowering
Raphanus_sativus	Malvids	Flowering
Brassica_oleracea	Malvids	Flowering
Brassica_napus	Malvids	Flowering
Sinapis_alba	Malvids	Flowering
Brassica_carinata	Malvids	Flowering
Brassica_nigra	Malvids	Flowering
Tripterygium_wilfordii	Fabids	Flowering
Averrhoa_carambola	Fabids	Flowering
Cephalotus_follicularis	Fabids	Flowering
Kandelia_obovata	Fabids	Flowering
Mercurialis_annua	Fabids	Flowering
Hevea_brasiliensis	Fabids	Flowering
Vernicia_fordii	Fabids	Flowering
Passiflora_organensis	Fabids	Flowering
Passiflora_edulis	Fabids	Flowering
Salix_brachista	Fabids	Flowering
Salix_suchowensis	Fabids	Flowering
Populus_glandulosa_x_alba	Fabids	Flowering
Populus_pruinosa	Fabids	Flowering
Populus_euphratica	Fabids	Flowering
Populus_trichocarpa	Fabids	Flowering
Populus_tremula	Fabids	Flowering
Populus_alba	Fabids	Flowering
Faidherbia_albida	Fabids	Flowering
Senna_tora	Fabids	Flowering
Mimosa_pudica	Fabids	Flowering
Lupinus_albus	Fabids	Flowering
Ammopiptanthus_nanus	Fabids	Flowering
Dalbergia_odorifera	Fabids	Flowering
Aeschynomene_evenia	Fabids	Flowering
Arachis_ipaensis	Fabids	Flowering
Arachis_monticola	Fabids	Flowering
Arachis_hypogaea	Fabids	Flowering
Lotus_japonicus	Fabids	Flowering
Pisum_sativum	Fabids	Flowering
Trifolium_subterranum	Fabids	Flowering
Trifolium_pratense	Fabids	Flowering
Medicago_ruthenica	Fabids	Flowering
Medicago_sativa	Fabids	Flowering
Medicago_truncatula	Fabids	Flowering
Medicago_polymorpha	Fabids	Flowering
Spatholobus_suberectus	Fabids	Flowering
Cajanus_cajan	Fabids	Flowering
Amphicarpaea_edgeworthii	Fabids	Flowering
Glycine_max	Fabids	Flowering
Glycine_soja	Fabids	Flowering
Vigna_subterranea	Fabids	Flowering
Vigna_angularis	Fabids	Flowering
Vigna_unguiculata	Fabids	Flowering
Lablab_purpureus	Fabids	Flowering
Phaseolus_lunatus	Fabids	Flowering
Phaseolus_vulgaris	Fabids	Flowering
Siraitia_grosvenorii	Fabids	Flowering
Momordica_charantia	Fabids	Flowering
Benincasa_hispida	Fabids	Flowering
Cucumis_hystrix	Fabids	Flowering
Cucurbita_argyrosperma	Fabids	Flowering
Cucurbita_moschata	Fabids	Flowering
Cucurbita_pepo	Fabids	Flowering
Cucurbita_maxima	Fabids	Flowering
Fagus_sylvatica	Fabids	Flowering
Castanea_mollissima	Fabids	Flowering
Quercus_suber	Fabids	Flowering
Quercus_robur	Fabids	Flowering
Quercus_lobata	Fabids	Flowering
Morella_rubra	Fabids	Flowering
Juglans_sigillata	Fabids	Flowering
Juglans_regia	Fabids	Flowering
Carya_cathayensis	Fabids	Flowering
Carya_illinoinensis	Fabids	Flowering
Casuarina_equisetifolia	Fabids	Flowering
Betula_pendula	Fabids	Flowering
Betula_platyphylla	Fabids	Flowering
Carpinus_fangiana	Fabids	Flowering
Corylus_heterophylla	Fabids	Flowering
Corylus_mandshurica	Fabids	Flowering
Ziziphus_jujuba	Fabids	Flowering
Trema_orientalis	Fabids	Flowering
Cannabis_sativa	Fabids	Flowering
Humulus_lupulus	Fabids	Flowering
Boehmeria_nivea	Fabids	Flowering
Ficus_microcarpa	Fabids	Flowering
Ficus_erecta	Fabids	Flowering
Artocarpus_camansi	Fabids	Flowering
Morus_notabilis	Fabids	Flowering
Artocarpus_altilis	Fabids	Flowering
Artocarpus_heterophyllus	Fabids	Flowering
Rubus_chingii	Fabids	Flowering
Rubus_occidentalis	Fabids	Flowering
Rosa_rugosa	Fabids	Flowering
Rosa_multiflora	Fabids	Flowering
Rosa_chinensis	Fabids	Flowering
Potentilla_micrantha	Fabids	Flowering
Fragaria_viridis	Fabids	Flowering
Fragaria_nubicola	Fabids	Flowering
Fragaria_nilgerrensis	Fabids	Flowering
Fragaria_iinumae	Fabids	Flowering
Fragaria_vesca	Fabids	Flowering
Malus_sylvestris	Fabids	Flowering
Malus_sieversii	Fabids	Flowering
Malus_baccata	Fabids	Flowering
Malus_x_domestica	Fabids	Flowering
Eriobotrya_japonica	Fabids	Flowering
Pyrus_communis	Fabids	Flowering
Pyrus_ussuriensis_x_communis	Fabids	Flowering
Pyrus_betulifolia	Fabids	Flowering
Prunus_yedoensis	Fabids	Flowering
Prunus_armeniaca	Fabids	Flowering
Prunus_sibirica	Fabids	Flowering
Prunus_dulcis	Fabids	Flowering
Prunus_persica	Fabids	Flowering
Prunus_domestica	Fabids	Flowering
Prunus_salicina	Fabids	Flowering
Prunus_mandshurica	Fabids	Flowering
Prunus_mume	Fabids	Flowering
